t,x,y,th,x,y,th,x,y,th,x,y,th,x,y,th,x,y,th,x,y,th,x,y,th,x,y,th,x,y,th,x,y,th,x,y,th,x,y,th,x,y,th,x,y,th
1,-7,15,0,-6,15,0,-5,15,0,-4,15,0,-3,15,0,-2,15,0,-1,15,0,0,15,0,1,15,0,2,15,0,3,15,0,4,15,0,5,15,0,6,15,0,7,15,0
62,-16,-2,0,-16,-1,0,-16,0,0,-16,1,0,-16,2,0,-15,-2,0,-15,-1,0,-15,0,0,-15,1,0,-15,2,0,-14,-2,0,-14,-1,0,-14,0,0,-14,1,0,-14,2,0
353,-16,-14,0,-16,-13,0,-16,-12,0,-16,-11,0,-16,-10,0,-15,-14,0,-15,-13,0,-15,-12,0,-15,-11,0,-15,-10,0,-14,-14,0,-14,-13,0,-14,-12,0,-14,-11,0,-14,-10,0
3954,-8,-16,0,-9,-16,0,-10,-16,0,-11,-16,0,-12,-16,0,-8,-15,0,-9,-15,0,-10,-15,0,-11,-15,0,-12,-15,0,-8,-14,0,-9,-14,0,-10,-14,0,-11,-14,0,-12,-14,0
9505,4,-8,0,3,-8,0,2,-8,0,1,-8,0,0,-8,0,4,-9,0,3,-9,0,2,-9,0,1,-9,0,0,-9,0,4,-10,0,3,-10,0,2,-10,0,1,-10,0,0,-10,0
15006,4,-16,0,3,-16,0,2,-16,0,1,-16,0,0,-16,0,4,-15,0,3,-15,0,2,-15,0,1,-15,0,0,-15,0,4,-14,0,3,-14,0,2,-14,0,1,-14,0,0,-14,0
29007,14,-16,0,13,-16,0,12,-16,0,11,-16,0,10,-16,0,14,-15,0,13,-15,0,12,-15,0,11,-15,0,10,-15,0,14,-14,0,13,-14,0,12,-14,0,11,-14,0,10,-14,0
30008,21,12,0,21,9,0,21,6,0,21,3,0,21,0,0,18,12,0,18,9,0,18,6,0,18,3,0,18,0,0,15,12,0,15,9,0,15,6,0,15,3,0,15,0,0